333333333333033333333333333
101000000000000000000000101
101033333333333330333330101
100000100010000010101010101
101033103310333013101011101
101000000000001000100000101
101033303330301033103333101
101000100010101010001000001
100033133010101310331033331
103000001010000000000000001
101033301011033033333033301
101000101310001311110000101
001033330000000000013333100
300000000330003333001000003
133030303113031111301330301
100010100000001111100010101
133010103330331111103330131
100010100010000000000000001
103010103010333033333333331
101010101010001000000000001
131010101010331030333333331
100010101010100010001000001
103010101313133010331033331
101010000000001010001000001
101013303333333010333333301
101000100000001010000000001
131333133333031313333333331